1111111111111111111111111111111111111111
1000000000000000000000000000000000000001
1000000000000000000000000000000000000001
1000000000000000000000000000000000000001
1000000000000000000000000000000000000001
1000000000000000000000000000000000000001
1000000000000000000000000000000000000001
1000000000000000000000000000000000000001
1000000000000000000000000000000000000001
1000000000000000000000000000000000000001
1000000000000000000000000000000000000001
1000000000000000000000000000000000000001
1000000000000000000000000000000000000001
1000000000000000000000000000000000000001
1000000000000000000000000000000000000001
1000000000000000000000000000000000000001
1000000000000000000000000000000000000001
1000000000000000000000220000000000001111
1000000000000000000000022222220000000001
1000000000000000000000000000000200200001
1000000000000000000000000000000000000001
1000000000000000000010000000002002002001
1004444400003000040012222222000001000001
1002222200022222220010000000000001000001
1022000010000000000110022222000001000011
1000000100222220011110020000001001000001
1222220001000000011110020000000001001001
1000020010000022222220020101111111111101
1000000000000000000000020000000000000001
1111111111111111111111111111111111111111

